C 12,42,13

EA  xpms/Asset3.xpm

SO xpms/Asset1.xpm     

WE xpms/Asset2.xpm

NO xpms/Asset4.xpm

F 31,62,5

            1111111111111111111111111111111111111111111111111
            1000111000000011000000000011000000000111 10000001
            1000000000000000000011100000000000000000100000001
            1000000000000001111100000000000010001100000000001
1111111111111000000100001100000001000000111011001111111111111
1000111000000011000000000011000000011110000001111
1000000000111000011100011000111001111001111100001
1000000000000000011000001011100000000000000000001
1000000000000000010011100000100000000000000000001
1000000000000011111110000111010000000110000000011
1000000111000000000000110000001000000010110000111
1000111000000011000000000011000010000111 10000001
1000000000111000011000011000111001111001111100001
1000000000E00000000000000000000000000000000000001
1000000000000000000011100000100010000000000000001
1000000000000001111100000000100010001100000000011
1000000111000000000000001100100010000000001100111
1000000111000000000000001100100010000000001100111
1111111111111111111111111111111111111111111111111
