SO xpms/wall_east.xpm
WE xpms/wall_north.xpm
NO xpms/wall_south.xpm
F 12,13,55
EA xpms/wall_west.xpm
C 25,20,123

1111111111111
1000000000001
10000000000N1
1000000000001
1111111111111